./res/img/tile/terrain.bmp
0,0 0,0 0,0 0,0 0,0 0,0 0,0 0,0 0,0 0,0 
0,0 0,0 0,0 0,0 0,0 0,0 0,0 0,0 0,0 0,0 
0,0 4,3 5,3 6,3 0,0 0,0 4,3 5,3 6,3 0,0
0,0 0,0 0,0 0,0 0,0 0,0 0,0 0,0 0,0 0,0 
0,0 0,0 0,0 4,3 5,3 5,3 6,3 0,0 0,0 0,0 
0,0 0,0 0,0 0,0 0,0 0,0 0,0 0,0 0,0 0,0 
2,2 2,2 2,2 2,2 2,2 2,2 2,2 2,2 2,2 2,2 
9,2 9,2 9,2 9,2 9,2 9,2 9,2 9,2 9,2 9,2 